
NO textures/simonkraft/wet_sponge.xpm
SO textures/simonkraft/wet_sponge.xpm
WE textures/simonkraft/wet_sponge.xpm
EA textures/simonkraft/wet_sponge.xpm

          F 164,169,20
C 153,204,255

                  111111
111111111111111111000001
1   00000000000000000001
1 N 11111111111111111111
1   1
11111





